{
    "lv1" : {
        "levelNumber": 1,
        "ballSpeed": 200,
        "paddleWidthRation": 0.2,
        "paddleHeightRation": 0.04,
        "map": [
            [0, 0, 0, 0, 0, 0, 0, 0, 0],
            [0, 0, 0, 0, 0, 0, 0, 0, 0],
            [0, 0, 0, 0, 0, 0, 0, 0, 0],
            [0, 0, 0, 4, 4, 4, 0, 0, 0],
            [0, 0, 0, 4, 2, 4, 0, 0, 0],
            [0, 0, 0, 4, 4, 4, 0, 0, 0]
        ]
    },
    "lv2" : {
        "levelNumber": 2,
        "ballSpeed": 200,
        "paddleWidthRation": 0.2,
        "paddleHeightRation": 0.04,
        "map": [
            [0, 0, 0, 0, 0, 0, 0, 0, 0],
            [0, 0, 0, 0, 0, 0, 0, 0, 0],
            [1, 1, 1, 1, 1, 1, 1, 1, 1],
            [5, 5, 5, 5, 5, 5, 5, 5, 5],
            [0, 0, 0, 0, 0, 0, 0, 0, 0],
            [0, 0, 0, 0, 0, 0, 0, 0, 0],
            [0, 3, 3, 0, 0, 0, 3, 3, 0]
        ]
    }, 
    "lv3" : {
        "levelNumber": 3,
        "ballSpeed": 200,
        "paddleWidthRation": 0.2,
        "paddleHeightRation": 0.04,
        "map": [
            [0, 0, 0, 0, 0, 0, 0, 0, 0],
            [0, 0, 0, 0, 0, 0, 0, 0, 0],
            [0, 0, 0, 0, 0, 0, 0, 0, 0],
            [0, 0, 0, 0, 0, 0, 0, 0, 0],
            [0, 0, 0, 0, 0, 0, 0, 0, 0],
            [2, 0, 2, 2, 0, 2, 2, 0, 2],
            [3, 1, 3, 3, 1, 3, 3, 1, 3]
        ]
    } 
}