{
    "lv1" : {
        "ballSpeed": 300,
        "paddleWidthRation": 0.15,
        "paddleHeightRation": 0.04,
        "map": [
            [0, 0, 0, 0, 0, 0, 0, 0, 0],
            [0, 0, 0, 0, 0, 0, 0, 0, 0],
            [2, 2, 2, 2, 2, 2, 2, 2, 2],
            [1, 1, 1, 1, 1, 1, 1, 1, 1],
            [2, 2, 2, 2, 2, 2, 2, 2, 2],
            [1, 1, 1, 1, 1, 1, 1, 1, 1]
        ]
    } 
}