{
    "lv1" : {
        "ballSpeed": 300,
        "paddleWidthRation": 0.2,
        "paddleHeightRation": 0.02,
        "map": [
            [0, 0, 0, 0, 0, 0, 0, 0, 0],
            [0, 0, 0, 0, 0, 0, 0, 0, 0],
            [1, 1, 1, 1, 1, 1, 1, 1, 1],
            [1, 1, 1, 1, 1, 1, 1, 1, 1],
            [1, 1, 1, 1, 1, 1, 1, 1, 1],
            [1, 1, 1, 1, 1, 1, 1, 1, 1]
        ]
    } 
}